******
**a***
**--f*
*--***
******