****************
*-**a*-*-*****-*
****-******--*-*
**-*--*-*--*---*
*-*--*-**----*-*
*------**-*----*
****-**---*-*--*
****-----*--*f-*
*--------------*
****************