****************
*-**a*-*-*---*-*
*--*-**--**--*-*
**-*--*-*f-*---*
*-*-*--**----*-*
*-**---****----*
*--*-**---*-*--*
****************